NO textures/wall.xpm
SO textures/wall_1_.xpm
WE textures/wall_2_.xpm
EA textures/wall_3_.xpm

F 191, 160, 116
C 229, 227, 196


     1111111111111111111111111111111
     1000000000000010000000000000001      1111111111
     1011110111111010111110111111101      1000000001
     1010000100000010000010100000101      1000010001
     1010111101111110111010111110101      1000010001
111111010111101111110111010111111111	  1010011011
1010000101000000001010000010101           1111010001
1011110101011111101110111010101           1111111111
1000000101000000100000100010101
1111111101110111111111111010101    1111111111
1000000000000100000000000010101    1000000001
1011111111110101111111111010111    1011111101
1010000000010001000000010010001    101    101  111
10101111110111110111110111111011111101    10111101
10100000100000000000100000000000000001    10000001
10111110101111111110101111111011111111111111111101
10000000100000000000100000000N10000000000000000101
11111111111111111111111111111110111111111111110101
10010000010100010000000000000000000000000000010101
10111111010101011111111111111111111111111111010101
10000000000000000000000000000000000000000000010101
11111111111111111111111111111111111111111111110101
10000000000000000000000000000000000000000000000001
11111111111111111111111111111111111111111111111111