NO textures/wall.xpm
SO textures/wall_1_.xpm
WE textures/wall_2_.xpm
EA textures/wall_3_.xpm

F 191, 160, 116
C 229, 227, 196


           111111111111   1111111111111111
1111       1000000000011111000000000000001
1001       1000000000000010000000000000001
1111       1011110111111010111110111111101
           1010000100000010000010100000101
           1010111101111110111010111110101
111111111111011111100010101010111111111111
1010000101000000001010000010101
1011110101011111101110111010101
1000000101000000100000100010101
1111111101110111111111111010101
1000000000000100000000000010101
1011111111110101111111111010111
1010000000010001000000010010001
1010111111011111011111011111101
1010000010000000000010000000001
1011111010111111111010111111101
10000000100000000000000000S00N1
1111111111111111111111111111111
