SO textures/wall_2_.xpm
NO textures/wall_2_.xpm
WE textures/wall_2_.xpm
EA textures/wall_2_.xpm

F 191, 160, 116
C 229, 227, 196

111111111
100000001
110101011
110101011
110101011
110101011
110101011
110101011
110101011
110101011
110101011
110101011
110101011
110101011
110101011
11d101011
11d101011
11d101n11
11d101n11
11d101n11
100000001
1000N0001
111111111