SO textures/wall_2_.xpm
NO textures/wall_2_.xpm
WE textures/wall_2_.xpm
EA textures/wall_2_.xpm

F 191, 160, 116
C 229, 227, 196


111111111111
100000000001
11D111011n11
100000000001
100000000001
10N000000001
111111111111