SO textures/wall.xpm
NO textures/wall_1_.xpm
WE textures/wall_2_.xpm
EA textures/wall_3_.xpm

F 191, 160, 116
C 229, 227, 196


1111111
1000001
111d111
1000001
1000001
100N001
1111111