SO textures/wall_2_.xpm
NO textures/wall_2_.xpm
WE textures/wall_2_.xpm
EA textures/wall_2_.xpm

F 191, 160, 116
C 229, 227, 196


111111111
100000001
11d1D1n11
100000001
100000001
100N00001
111111111
