NO textures/wall.xpm
SO textures/wall_1_.xpm
WE textures/wall_2_.xpm
EA textures/wall_3_.xpm

F 191, 160, 116
C 229, 227, 196
















               1
               1
               1111
                  1
                  1
                  111
                11111
                1
         11111111
        110000000
       1100000000
      11000111111
111111100011    1
10000100011     1
1000000011      1
100000011       1
10000111        1111
10N001             1
100001             1
100001             1
100001             1
111111             11
                    11
                     11
                      1
                      1
                      1
                      1
                      1
                      1111111
                            1
                            111111111111111