SO textures/south.xpm
NO textures/north.xpm
WE textures/west.xpm
EA textures/east.xpm

F 191, 160, 116
C 229, 227, 196

                                   111111111111
                                   100000000001
                                   100000000001
                                   100000000001
                                   100000000001
                                   100000000001 11111111111
                                   100000000001 10000000001
                                   100000000001110000000001
                                   100000000000000000000001
                                   100000000000000000000001
                                   100000000001110000000001
                                   100000000001 10000000001
                                   111111111111 10000000001
                                                11111001111
                         111111111                  100011
           11111111111111100000001                  1100011
           10000000000010000000001                   110001
           10000000000010000000001                    110011111111
           10000000000000000000001                     10000000001
           10000000000010100000001     111111111111111110000000001
           10000000000011100000001  111100000000000000000000000001
           1000000000001 1000000011 100100000000110000000000000001
           1000000000001 11111110011100100000000110011110000000001
           1111000011111       1100000000000000011111  11111111111
              100001            11100001000000001
              111001              100111000000001
                1001              1111 1111111111
                1001
                10011
                10001
               110001111
               100000001
               111100001
                  1000011
                  1000001
                  1110001
                111110001
                100000001            11111111111
         1111111100000001            10000000001
        11000000000010001            10000000001
       110000000000010001            10000000001
      1100011111100010001            10000000001
111111100011    100010001            10000000001
10000100011     100010001            10000000001
1000000011      100000001            100000000011
100000011       100000001            1000000000011
10000111        111100001            11111111110011
100001             100001                     110011
100001             100111111111111111111111    1100111
10N001             100100001100000000000001     100001
100001             100100001100000000000001     100001
111111             110000001100000000000001     100001
                    11000001100000000000001    1100001
                     1100001100000000000001   11001111
                      10000000000000000000111110001
                      10000110000000000000000000111
                      100001100000000000001110011
                      100001100000000000001 1111
                      100001100000000000001
                      111111100000000000001
                            100000000000001
                            111111111111111