NO textures/wall.xpm
SO textures/wall_1_.xpm
WE textures/wall_2_.xpm
EA textures/wall_3_.xpm

F 191, 160, 116
C 229, 227, 196

1111111111111111111111111111111111111111111111
1000000000001111110000111111110000000000000001
1000000000001111110000111111110000000000000001
1000000000001111110000111111110000000000000001
1000000000000000000000000000000000000000000001
1111111111000000000000000000000000011111111111
1000000001000000000000000000000000010000000001
1000000001000000000000000000000000010000000001
1000000001000000000000000000000000010000000001
1111111111000000111111111111110000010000000001
1000000000000000110000000000110000010000000001
1000000000000000110000000000110000010000000001
1000000000000000110000000000111111110000000001
1000000000000000110000000000000000000000000001
1000000000000000110000000000000000000000000001
1111111111110000111111111111000000001111111111
1000000000010000000000000001000000001000000001
1000000000010000000000000001000000001000000001
1000000000010000000000000001000000001000000001
1000000000011111111111111111000000001000000001
1000000000000000000000000000000000000000000001
10000000000000000000000000000000000000000000N1
1111111111111111111111111111111111111111111111
