NO textures/north.xpm
SO textures/south.xpm
WE textures/west.xpm
EA textures/east.xpm

F 191, 160, 116
C 229, 227, 196

11111
10001
10N01
10001
11111