NO textures/wall.xpm
SO textures/wall_1_.xpm
WE textures/wall_2_.xpm
EA textures/wall_3_.xpm

F 191, a, 116
C 229, 227, 196

11111111
10000001
100N0001
11111111