NO textures/wall.xpm
SO textures/wall_1_.xpm
WE textures/wall_2_.xpm
EA textures/wall_3_.xpm

F 191, 160, 116, 20
C 229, 227,	230, 120

11111111
10000001
100S0001
11111111